|-----------------------------------------------------------------------------|
|                                                                             |
| |--------------------------|        |-----------------------|               |
| |..........................|        |.......................|               |
| |..........................+########+.......................|-------|       |
| |..........................|   #    |...............................|--|    |
| |..........................|   #    |..................................|--| |
| |----------+---------------|   #    |----+----------------|...............| |
|            #                 #############                |...............| |
|            #                 #     |-----+------|         |...............| |
|            #                 #     |............|         |...............| |
|            ###################     |............|   ######+...............| |
|            #                 #     |............|   #     |...............| |
|            #                 #     |-----+------|   #     |--------+------| |
| |----------+-----------|     #           #          #              #        |
| |......................|     #           #          #         |----+------| |
| |......................|     ########################         |...........| |
| |......................|     #           #                    |...........| |
| |......................|     #    |------+--------------------|...........| |
| |......................|     #    |.......................................| |
| |......................+##########+.......................................| |
| |......................|          |.......................................| |
| |----------------------|          |---------------------------------------| |
|                                                                             |
|-----------------------------------------------------------------------------|
